"filename", "language", "Go", "Log", "comment", "blank", "total"
"d:\GOPATH__MY\src\kv-raft\kvraft\client.go", "Go", 60, 0, 20, 11, 91
"d:\GOPATH__MY\src\kv-raft\kvraft\common.go", "Go", 56, 0, 6, 13, 75
"d:\GOPATH__MY\src\kv-raft\kvraft\config.go", "Go", 316, 0, 54, 56, 426
"d:\GOPATH__MY\src\kv-raft\kvraft\kvengine\BST.go", "Go", 134, 0, 18, 9, 161
"d:\GOPATH__MY\src\kv-raft\kvraft\kvengine\BST_test.go", "Go", 42, 0, 0, 4, 46
"d:\GOPATH__MY\src\kv-raft\kvraft\kvengine\checker.go", "Go", 18, 0, 4, 3, 25
"d:\GOPATH__MY\src\kv-raft\kvraft\kvengine\compaction.go", "Go", 77, 0, 12, 17, 106
"d:\GOPATH__MY\src\kv-raft\kvraft\kvengine\config.go", "Go", 19, 0, 8, 7, 34
"d:\GOPATH__MY\src\kv-raft\kvraft\kvengine\database.go", "Go", 7, 0, 1, 2, 10
"d:\GOPATH__MY\src\kv-raft\kvraft\kvengine\dbfile.go", "Go", 48, 0, 5, 6, 59
"d:\GOPATH__MY\src\kv-raft\kvraft\kvengine\memtable.go", "Go", 7, 0, 2, 3, 12
"d:\GOPATH__MY\src\kv-raft\kvraft\kvengine\search.go", "Go", 50, 0, 7, 9, 66
"d:\GOPATH__MY\src\kv-raft\kvraft\kvengine\sstable.go", "Go", 229, 0, 37, 39, 305
"d:\GOPATH__MY\src\kv-raft\kvraft\kvengine\util.go", "Go", 15, 0, 3, 6, 24
"d:\GOPATH__MY\src\kv-raft\kvraft\kvengine\value.go", "Go", 6, 0, 0, 2, 8
"d:\GOPATH__MY\src\kv-raft\kvraft\kvengine\wal.go", "Go", 98, 0, 12, 15, 125
"d:\GOPATH__MY\src\kv-raft\kvraft\kvengine\wal_test.go", "Go", 26, 0, 0, 2, 28
"d:\GOPATH__MY\src\kv-raft\kvraft\kvstatemachine.go", "Go", 28, 0, 3, 5, 36
"d:\GOPATH__MY\src\kv-raft\kvraft\kvstatemachine_test.go", "Go", 17, 0, 0, 3, 20
"d:\GOPATH__MY\src\kv-raft\kvraft\logs\0.log", "Log", 0, 121, 0, 1, 122
"d:\GOPATH__MY\src\kv-raft\kvraft\logs\1.log", "Log", 0, 163, 0, 1, 164
"d:\GOPATH__MY\src\kv-raft\kvraft\logs\2.log", "Log", 0, 126, 0, 1, 127
"d:\GOPATH__MY\src\kv-raft\kvraft\logs\3.log", "Log", 0, 480, 0, 1, 481
"d:\GOPATH__MY\src\kv-raft\kvraft\logs\4.log", "Log", 0, 120, 0, 1, 121
"d:\GOPATH__MY\src\kv-raft\kvraft\logs\5.log", "Log", 0, 131, 0, 1, 132
"d:\GOPATH__MY\src\kv-raft\kvraft\logs\6.log", "Log", 0, 122, 0, 1, 123
"d:\GOPATH__MY\src\kv-raft\kvraft\server.go", "Go", 176, 0, 62, 32, 270
"d:\GOPATH__MY\src\kv-raft\kvraft\test_test.go", "Go", 522, 0, 90, 104, 716
"Total", "-", 1951, 1263, 344, 355, 3913